SFO|49ers
CHI|Bears
CIN|Bengals
BUF|Bills
DEN|Broncos
CLE|Browns
ARI|Cardinals
LAC|Chargers
KAN|Chiefs
IND|Colts
DAL|Cowboys
MIA|Dolphins
PHI|Eagles
ATL|Falcons
NYG|Giants
JAX|Jaguars
NYJ|Jets
DET|Lions
GNB|Packers
CAR|Panthers
NWE|Patriots
LVR|Raiders
LAR|Rams
BAL|Ravens
WAS|Commanders
NOR|Saints
SEA|Seahawks
PIT|Steelers
TAM|Tampa Bay
HOU|Texans
TEN|Titans
MIN|Vikings